{
  "dimension": 8,
  "map": [
      ["?", "T", "?", "?", "?", "?", "?", "?"],
      ["?", "T", "?", "?", "?", "?", "T", "?"],
      ["?", "?", "?", "?", "T", "?", "?", "T"],
      ["T", "?", "?", "?", "?", "T", "?", "?"],
      ["?", "?", "?", "T", "?", "?", "?", "?"],
      ["?", "?", "T", "?", "?", "?", "T", "?"],
      ["?", "?", "?", "?", "?", "?", "T", "T"],
      ["?", "?", "?", "?", "?", "?", "?", "?"]
  ],
  "rowHints": [1,2,1,2,2,1,2,1],
  "colHints": [1,1,2,1,1,2,0,4]
}
